3 15 25
8 8 8 8 8 8 8 8 8 8 8 8 8 8 8 8 8 8 8 8 8 8 8 8 8
8 7 0 0 0 0 0 0 0 0 0 0 0 0 0 0 0 0 0 0 0 0 0 0 8
8 0 2 0 2 0 2 0 2 0 2 0 2 6 2 3 2 0 2 3 2 0 2 0 8
8 0 3 3 3 3 3 3 3 3 3 0 0 0 3 3 3 3 3 3 3 0 0 0 8
8 0 2 3 2 0 2 0 2 0 2 0 2 0 2 0 2 3 2 0 2 0 2 0 8
8 0 0 0 0 0 0 0 0 0 0 0 0 0 0 0 0 3 0 0 0 0 0 0 8
8 0 2 3 2 0 2 0 2 0 2 0 2 0 2 0 2 3 2 0 2 0 2 0 8
8 0 0 0 3 3 3 3 0 0 0 0 0 0 0 0 0 0 0 0 0 0 0 0 8
8 0 2 0 2 0 2 3 2 0 2 0 2 0 2 0 2 3 2 0 2 0 2 0 8
8 0 0 0 0 0 0 0 0 0 0 0 0 0 0 0 0 3 0 0 0 0 0 0 8
8 0 2 0 2 0 2 3 2 3 2 0 2 0 2 0 2 3 2 0 2 0 2 0 8
8 0 3 3 3 3 3 3 5 4 6 0 0 0 0 0 0 0 0 0 0 0 0 0 8
8 0 2 0 2 0 2 0 2 0 2 0 2 0 2 0 2 0 2 0 2 0 2 0 8
8 0 0 0 0 0 0 0 0 0 0 0 0 0 0 0 0 0 0 0 0 0 0 0 8
8 8 8 8 8 8 8 8 8 8 8 8 8 8 8 8 8 8 8 8 8 8 8 8 8