2 15 25
8 8 8 8 8 8 8 8 8 8 8 8 8 8 8 8 8 8 8 8 8 8 8 8 8
8 7 0 0 0 0 0 0 0 0 0 0 0 0 0 0 0 0 0 0 0 0 0 0 8
8 0 2 0 0 3 2 0 0 0 0 0 2 2 2 0 0 0 2 0 0 0 0 0 8
8 0 2 0 0 2 0 3 0 0 0 3 0 0 0 2 0 0 2 0 0 0 0 0 8
8 0 3 0 0 2 0 0 2 0 0 2 0 0 0 3 0 0 2 0 0 0 0 0 8
8 0 3 0 0 2 0 0 3 0 0 2 0 0 0 2 0 0 2 0 0 0 0 0 8
8 0 2 0 0 2 0 0 3 0 0 2 0 0 0 2 0 0 2 0 0 0 0 0 8
8 0 2 0 0 3 0 0 2 0 0 3 0 0 0 2 0 0 2 0 0 0 0 0 8
8 0 2 0 0 2 0 0 3 0 0 2 0 0 0 2 0 0 2 0 0 0 0 0 8
8 0 4 0 0 2 0 0 2 0 0 2 0 0 0 2 0 0 2 0 0 0 0 0 8
8 0 2 0 0 2 0 0 3 0 0 2 0 0 0 5 0 0 2 0 0 0 0 0 8
8 0 2 0 0 2 0 0 3 0 0 2 0 0 0 2 0 0 2 0 0 0 0 0 8
8 0 2 0 0 2 2 2 0 0 0 0 3 2 3 0 0 0 2 2 2 2 0 0 8
8 0 0 0 0 0 0 0 0 0 0 0 0 0 0 0 0 0 0 0 0 0 0 0 8
8 8 8 8 8 8 8 8 8 8 8 8 8 8 8 8 8 8 8 8 8 8 8 8 8